11111111111111122111111000000
11111110011111122111111100000
11111000111111122111111111111
11110001111111122111111111111
33333333333311112211111111111
11111111111311111221111111111
11111111111311111122111111111
11111111113331111122111111111
11112221113333333333333333333
11122222113331111122111111111
11112221111111111221111111111
11111122222222222211111111111
11111111111221111111111111111
11111000112211111111111111111
11111001122111100000011111111
11111111122111000000111111111
11111111122111100001111111111
11111111002211111111111111111
11111111101221111111111111111
11111111111122111111111111111
11111111111122111111111111111
11111111111122111111111111111